###################################################################################################################################################
#.............#.............#..............................#..........................................#...............#.............#.............#
#.............#.............#..............................#..........................................#...............#.............#.............#
#.............#.............#..............................#..........................................#...............#.............#.............#
#.............#.............#..............................#..........................................#...............#.............#.............#
#.............#.............#..............................#..........................................#...............#.............#.............#
#.............#.............#..............................#..........................................#...............#.............#.............#
#.............#.............#..............................#..........................................#...............#.............#.............#
#.............#.............#..............................#..........................................#...............#.............#.............#
#.............#.............#..............................#..........................................#...............#.............#.............#
#...........................................################...........................#..............#...........................................#
#..........................................................#...........................#..............#...........................................#
#..........................................................#...........................#..............#...........................................#
#..........................................................#...........................#..............#...........................................#
#..........................................................#...........................#..............#...........................................#
#..........................................................#...........................#..............#...........................................#
#..........................................................#...........................#..............#...........................................#
#..........................................................#...........................#..............#...........................................#
#..........................................................#...........................#..............#...........................................#
###############.............################...............###############.............################################.............#.............#
#.............#.............#..............................#...........................#............................................#.............#
#.............#.............#..............................#...........................#............................................#.............#
#.............#.............#..............................#...........................#............................................#.............#
#.............#.............#..............................#...........................#............................................#.............#
#.............#.............#..............................#...........................#............................................#.............#
#.............#.............#..............................#...........................#............................................#.............#
#.............#.............#..............................#...........................#............................................#.............#
#.............#.............#..............................#...........................#............................................#.............#
#.............#.............################################...........................#..............#................##############.............#
#.............#.............#...............#..............#...........................#..............#.............................#.............#
#.............#.............#...............#..............#...........................#..............#.............................#.............#
#.............#.............#...............#..............#...........................#..............#.............................#.............#
#.............#.............#...............#..............#...........................#..............#.............................#.............#
#.............#.............#...............#..............#...........................#..............#.............................#.............#
#.............#.............#...............#..............#...........................#..............#.............................#.............#
#.............#.............#...............#..............#...........................#..............#.............................#.............#
#.............#.............#...............#..............#...........................#..............#.............................#.............#
#.............#.............................#..........................................#..............###############################.............#
#.............#.............................#..........................................#..............#...............#...........................#
#.............#.............................#..........................................#..............#...............#...........................#
#.............#.............................#..........................................#..............#...............#...........................#
#.............#.............................#..........................................#..............#...............#...........................#
#.............#.............................#..........................................#..............#...............#...........................#
#.............#.............................#..........................................#..............#...............#...........................#
#.............#.............................#..........................................#..............#...............#...........................#
#.............#.............................#..........................................#..............#...............#...........................#
#.............#.............................#..........................................#..............#...............#...........................#
#.............#.............#..............................#..........................................#...............#.............#.............#
#.............#.............#..............................#..........................................#...............#.............#.............#
#.............#.............#..............................#..........................................#...............#.............#.............#
#.............#.............#..............................#..........................................#...............#.............#.............#
#.............#.............#..............................#..........................................#...............#.............#.............#
#.............#.............#..............................#..........................................#...............#.............#.............#
#.............#.............#..............................#..........................................#...............#.............#.............#
#.............#.............#..............................#..........................................#...............#.............#.............#
#.............#.............#..............................#..........................................#...............#.............#.............#
#.............#.............#..............................#...........................################...............###############.............#
#...........................#...............#..............#...........................#..............#...............#.............#.............#
#...........................#...............#..............#...........................#..............#...............#.............#.............#
#...........................#...............#..............#...........................#..............#...............#.............#.............#
#...........................#...............#..............#...........................#..............#...............#.............#.............#
#...........................#...............#..............#...........................#..............#...............#.............#.............#
#...........................#...............#..............#...........................#..............#...............#.............#.............#
#...........................#...............#..............#...........................#..............#...............#.............#.............#
#...........................#...............#..............#...........................#..............#...............#.............#.............#
#.............###############################..............#############################..............#...............#.............#.............#
#.............#.............#..............................#......................................................................................#
#.............#.............#..............................#......................................................................................#
#.............#.............#..............................#......................................................................................#
#.............#.............#..............................#......................................................................................#
#.............#.............#..............................#......................................................................................#
#.............#.............#..............................#......................................................................................#
#.............#.............#..............................#......................................................................................#
#.............#.............#..............................#......................................................................................#
###############.............#################..............#......................................................................................#
#...........................................#..........................................#..............#...............#.............#.............#
#...........................................#..........................................#..............#...............#.............#.............#
#...........................................#..........................................#..............#...............#.............#.............#
#...........................................#..........................................#..............#...............#.............#.............#
#...........................................#..........................................#..............#...............#.............#.............#
#...........................................#..........................................#..............#...............#.............#.............#
#...........................................#..........................................#..............#...............#.............#.............#
#...........................................#..........................................#..............#...............#.............#.............#
############################................#............................##########################################################################
#..........................................................#......................................................................................#
#..........................................................#......................................................................................#
#..........................................................#......................................................................................#
#..........................................................#......................................................................................#
#..........................................................#......................................................................................#
#..........................................................#......................................................................................#
#..........................................................#......................................................................................#
#..........................................................#......................................................................................#
#..........................................................#......................................................................................#
###################################################################################################################################################
